
NO assets/NO.xpm42
EA assets/EA.xpm42
WE assets/WE.xpm42
SO assets/SO.xpm42


F 72,122,2
C 66,135,245

1111111
1000001
1000N01
1111111