
NO img/greystone.xpm
EA img/mossy.xpm
WE img/stone.xpm
SO img/stone2.xpm

F 220,100,0
C 225,30,0

        11111111111111111111111
       1N00000000110000000000011
        1011000001110000000000001
111    1001000000000000000000001
11111111101100001110000000000001
100000000011000001110111111111111
11110111111111011100000010001
11110111111111011101010010001
10000000111101011100000010001
10000000000000001100000010001
10000000000000001101010010001
1100000111010101111101111001
11110111 1110101 101111010001
11111111 1111111 111111111111